4 5 4 5 4 5 4 5 4 5 4 5 4 5 4 5 4 5 4 5 4 5 4 5 4 5 4 5 4 5 4
5 0 2 2 0 0 2 0 0 0 2 2 0 0 0 0 0 0 0 0 0 3 3 0 0 3 3 3 3 0 5
4 0 0 0 0 0 0 0 0 0 0 0 0 0 0 0 0 0 0 0 3 0 0 0 3 0 0 3 0 0 4
5 2 0 0 0 2 2 2 2 0 0 0 0 0 0 0 0 0 0 3 0 0 0 0 0 0 0 0 0 3 5
4 2 0 0 2 2 2 2 0 0 0 2 0 0 0 0 0 0 0 0 0 0 3 3 0 0 3 3 0 3 4
5 2 0 0 0 0 2 0 0 0 2 2 0 0 0 0 0 0 0 0 0 0 0 3 3 3 3 3 0 0 5
4 0 0 0 0 0 0 0 0 0 2 1 0 1 0 1 0 0 0 0 0 0 3 3 3 0 0 0 0 0 4
5 0 2 0 0 0 0 0 0 0 1 0 1 0 1 0 0 3 3 3 0 0 3 3 0 0 0 3 3 0 5
4 0 0 0 2 3 2 0 0 0 0 1 0 1 0 1 0 0 0 0 0 0 3 0 0 0 0 0 0 0 4
5 0 0 0 3 2 0 0 0 0 0 1 1 0 1 0 0 0 0 0 0 0 0 0 0 0 3 0 0 0 5
4 0 0 0 0 0 0 0 0 0 0 1 0 0 0 0 0 0 0 0 0 3 0 0 0 0 0 0 3 0 4
5 0 0 0 0 0 3 3 3 0 0 0 0 1 1 0 0 0 0 0 0 0 0 0 0 0 0 0 0 0 5
4 3 0 0 0 0 0 0 0 0 0 0 0 0 1 0 0 0 0 0 0 0 2 3 0 0 0 0 0 0 4
5 3 3 0 0 0 0 0 0 0 0 0 0 0 0 0 0 0 0 0 0 0 0 0 0 3 2 0 0 0 5
4 3 0 0 0 0 3 0 0 0 0 0 0 0 0 0 0 0 2 0 0 0 0 0 0 0 0 0 0 0 4
5 0 0 0 0 0 3 0 0 0 0 3 0 0 0 0 0 2 2 2 0 0 2 2 0 0 0 0 0 0 5
4 0 0 3 3 0 3 0 0 3 3 3 3 0 0 0 0 2 2 0 0 0 2 2 2 2 0 0 0 0 4
5 0 3 3 3 0 0 0 0 0 3 3 0 0 0 0 0 0 0 0 0 0 0 2 2 0 0 0 0 0 5
4 0 3 0 0 0 0 3 0 0 0 0 0 0 0 2 0 0 0 2 2 2 0 0 0 0 0 2 2 0 4
5 0 0 0 0 0 3 3 3 0 0 0 0 0 0 0 0 0 2 2 2 0 0 2 2 0 0 2 0 0 5
4 5 4 5 4 5 4 5 4 5 4 5 4 5 4 5 4 5 4 5 4 5 4 5 4 5 4 5 4 5 4